01 01 01 01 01 01 01 01 01 01 01 01 01 01 01 01 01 01 01 01 01
01 01 05 06 01 01 05 10 10 10 10 10 10 10 06 01 01 01 01 01 01
01 01 03 04 01 01 03 15 11 11 11 11 11 12 04 01 01 05 06 01 01
01 01 03 04 01 01 03 04 09 01 01 01 01 03 04 01 01 03 04 01 01
01 01 03 04 01 01 03 14 10 10 06 01 01 03 04 01 01 03 04 01 01
01 01 03 04 01 01 07 11 11 12 04 01 01 03 04 01 01 03 04 01 01
01 09 03 04 01 01 01 01 01 03 04 01 01 03 04 01 01 03 04 01 01
01 05 13 04 01 01 01 01 01 03 04 01 01 03 04 01 01 03 04 01 01
01 03 15 08 01 05 10 10 10 13 04 01 01 03 04 01 01 03 04 01 01
01 03 04 01 01 03 15 11 11 11 08 01 01 03 04 09 01 03 04 01 01
01 03 14 10 10 13 04 09 01 01 01 01 01 03 14 10 10 13 04 01 01
01 07 11 11 11 11 08 01 01 01 01 01 01 07 11 11 11 11 08 01 01
01 01 01 01 01 01 01 01 01 01 01 01 01 01 01 01 01 01 01 01 01